777777777777777
721044000440137
710401444104017
704058101680407
740040040040047
740020010030047
704000010000407
710400101004017
701041000140107
700104000401007
700010404010007
720001040100037
777777777777777