777777777777777
711012444210117
700042000240007
744402141204447
733302404203337
700000010001017
714150101501417
710100010000007
733302404203337
711102141201117
700012000210007
744012444210447
777777777777777